PAULA MONTAL IKASTETXEA	paula	montal
Aranbizkarra ikastola	bizkarra
CEIP DIVINO MAESTRO - MARÍA DE MAEZTU	divino
Abetxuko Ikastola	abetxuko
Santa María de Vitoria	santa maria de vitoria
SANTA MARÍA -MARIANISTAS	marianistas
CEIP MIGUEL DE CERVANTES HLHI	cervantes
KOLDO MITXELENA	mitxelena
CPI MENDIALDEA IPI	mendialdea
Calasanz	calasanz	escolapios
Luis Elejalde Rogeloia de Álvaro	elejalde
Ayalde	ayalde
CEIP Urkitza HLHI	urkitza
Maristak Bilbao	marista
Nuestra Señora de las Mercedes	la merced	mercedarias	mercedes
Karmengo Ama Ikastetxea	karmengo
Vda. de Epalza	epalza
Lauro Ikastola	lauro
Esclavas SC-Fátima	esclavas	fatima
Gernika BHI	gernika
Lauaxeta Ikastola	lauaxeta
Mujika Eskola	mujika
Juan Delmas/Zamakola eskol	delmas	zamakola	juan delm	del mas
CEIP GOIKOLANDA HLHI	goiko
Bakuva	bakuva
CEIP ZUBILETA HLHI	zubileta
Maestro Zubeldia	zubeldia
Txomin Aresti	aresti
MARKONZAGA	markonzaga
ANDER DEUNA IKASTOLA	deuna
JESUITINAS - LA INMACULADA	inmaculada	jesuitinas
Indautxuko eskola	indautxu
Santa María - Hijas de la Cruz	hijas de la cruz
Berriatua eskola HHLH	berriatu
ZAMUDIO HLHI	zamudio
MENDIA HLHI	mendia
KANPAZAR HLHI	kanpazar
El Carmelo	carmelo
LEARRETA MARKINA HLHI	learreta	markina
Berakruz Ikastola	kruz
Cervantes HLHI
Sagrado Corazón	sagrado corazon
IES URBI	urbi
J.A. ZUNZUNEGUI BHI	zunzunegui
LARRAMENDI IKASTOLA	larramendi
El Regato	regato
URIBARRI HLHI	uribarri
Zubi Zaharra Ikastola	zaharra
Ntra. Sra. del Carmen	carmen
San Felix Ikastetxea	felix
C.E.I.P. ZURBARAN HLHI	zurbaran
Nuestra Señora del Pilar	pilar
Irlandesas	irlandesas
Jesus Maria ikastetxea
LA SALLE BILBAO	salle
Alkartu ikastola	alkartu
INTXIXU IKASTOLA	intxixu
Jado Ikastetxea	jado
HLHI Lemoiz	lemoiz
CEIP JUAN RAMÓN JIMÉNEZ	juan ramon
CEIP Mina del Morro	morro
CEIPROMO HLHI	romo
San Antonio	san antonio
DEUSTUKO ESKOLA HLHI	deust
ISPASTERKO ESKOLA	ispaster
Liceo Francés de Bilbao	frances	lycee
Barrutialde BHI	barruti
Berrio-Otxoa Ikastetxea	berrio	otxoa
ALDATZE - SANT MARIA DE LA PROVIDENCIA	provid
Zumaiena (Maria eta Jose)	zumaiena	maria eta
Ibai ikastola	ibai
SALESIANOS DONOSTIA	salesianos
Iraurgi Ikastetxea	iraurgi
Olaberria LHI	olaberri
Deutsche Schule San Alberto Magno	aleman	deutsche	magno
ELIZATXO IKASTOLA	elizatxo
AMASSORRAIN IKASTOLA	amassorrain
igeldoko eskola	igeldo
EGAPE IKASTOLA HHLHI	egape
Urdaneta	urdaneta
SolokoetxeBHI	soloko
The english School	english
San Viator	viator